R 1024 768
NO ./texs/test_NO.xpm
SO ./texs/test_SO.xpm
WE ./texs/test_WE.xpm
EA ./texs/test_EA.xpm
S ./texs/test_S.xpm
F 80,80,80
C 80,80,80

 1111111111
10222001000111
100000010000011
1022200101100001
10000W001  100001
 120000001100001
  10000000000001
   10000000000001
   1000000011111
   100000001
   1111111111111