R 1920 1080
NO ./texs/test_NO.xpm
SO ./texs/test_SO.xpm
WE ./texs/test_WE.xpm
EA ./texs/test_EA.xpm
S ./texs/test_S.xpm

F 80,80,80
C 80,80,80

111111111111
122222222221
122000000221
122000000221
122000000221
122000000221
12200N000221
122000000221
122000000221
122000000221
122222222221
122222222221
111111111111
122222222221
122222222221
122222222221
122222222221
122222222221
122222222221
122222222221
122222222221
122222222221
122222222221
122222222221
122222222221
122222222221
122222222221
122222222221
122222222221
122222222221
122222222221
122222222221
122222222221
122222222221
122222222221
122222222221
122222222221
122222222221
122222222221
122222222221
122222222221
122222222221
122222222221
122222222221
122222222221
122222222221
122222222221
122222222221
122222222221
122222222221
122222222221
122222222221
122222222221
122222222221
122222222221
122222222221
122222222221
122222222221
122222222221
122222222221
122222222221
122222222221
122222222221
122222222221
122222222221
122222222221
122222222221
122222222221
122222222221
122222222221
122222222221
122222222221
122222222221
122222222221
122222222221
122222222221
122222222221
122222222221
122222222221
122222222221
122222222221
122222222221
122222222221
122222222221
122222222221
122222222221
122222222221
122222222221
122222222221
122222222221
122222222221
122222222221
122222222221
122222222221
122222222221
122222222221
122222222221
122222222221
122222222221
122222222221
122222222221
122222222221
122222222221
122222222221
122222222221
122222222221
122222222221
122222222221
122222222221
122222222221
122222222221
122222222221
122222222221
122222222221
122222222221
122222222221
122222222221
122222222221
122222222221
122222222221
122222222221
122222222221
122222222221
122222222221
122222222221
122222222221
122222222221
122222222221
122222222221
122222222221
122222222221
122222222221
122222222221
122222222221
122222222221
122222222221
122222222221
122222222221
122222222221
122222222221
122222222221
122222222221
122222222221
122222222221
122222222221
122222222221
122222222221
122222222221
122222222221
122222222221
122222222221
122222222221
122222222221
122222222221
122222222221
122222222221
122222222221
122222222221
122222222221
122222222221
122222222221
122222222221
122222222221
122222222221
122222222221
122222222221
122222222221
122222222221
122222222221
122222222221
122222222221
122222222221
122222222221
122222222221
122222222221
122222222221
122222222221
122222222221
122222222221
122222222221
122222222221
122222222221
122222222221
122222222221
122222222221
122222222221
122222222221
122222222221
122222222221
122222222221
122222222221
122222222221
122222222221
122222222221
122222222221
122222222221
122222222221
122222222221
122222222221
122222222221
122222222221
122222222221
122222222221
122222222221
122222222221
122222222221
122222222221
122222222221
122222222221
122222222221
122222222221
122222222221
122222222221
122222222221
122222222221
122222222221
122222222221
122222222221
122222222221
122222222221
122222222221
122222222221
122222222221
122222222221
122222222221
122222222221
122222222221
122222222221
122222222221
122222222221
122222222221
122222222221
122222222221
122222222221
122222222221
122222222221
122222222221
122222222221
122222222221
122222222221
122222222221
122222222221
122222222221
122222222221
122222222221
122222222221
122222222221
122222222221
122222222221
122222222221
122222222221
122222222221
122222222221
122222222221
122222222221
122222222221
122222222221
122222222221
122222222221
122222222221
122222222221
122222222221
122222222221
122222222221
122222222221
122222222221
122222222221
122222222221
122222222221
122222222221
122222222221
122222222221
122222222221
122222222221
122222222221
122222222221
122222222221
122222222221
122222222221
122222222221
122222222221
122222222221
122222222221
122222222221
122222222221
122222222221
122222222221
122222222221
122222222221
122222222221
122222222221
122222222221
122222222221
122222222221
122222222221
122222222221
122222222221
122222222221
122222222221
122222222221
122222222221
122222222221
122222222221
122222222221
122222222221
122222222221
122222222221
122222222221
122222222221
122222222221
122222222221
122222222221
122222222221
122222222221
122222222221
122222222221
122222222221
122222222221
122222222221
122222222221
122222222221
122222222221
122222222221
122222222221
122222222221
122222222221
122222222221
122222222221
122222222221
122222222221
122222222221
122222222221
122222222221
122222222221
122222222221
122222222221
122222222221
122222222221
122222222221
122222222221
122222222221
122222222221
122222222221
122222222221
122222222221
122222222221
122222222221
122222222221
122222222221
122222222221
122222222221
122222222221
122222222221
122222222221
122222222221
122222222221
122222222221
122222222221
122222222221
122222222221
122222222221
122222222221
122222222221
122222222221
122222222221
122222222221
122222222221
122222222221
122222222221
122222222221
122222222221
122222222221
122222222221
122222222221
122222222221
122222222221
122222222221
122222222221
122222222221
122222222221
122222222221
122222222221
122222222221
122222222221
122222222221
122222222221
122222222221
122222222221
122222222221
122222222221
122222222221
122222222221
122222222221
122222222221
122222222221
122222222221
122222222221
122222222221
122222222221
122222222221
122222222221
122222222221
122222222221
122222222221
122222222221
122222222221
122222222221
122222222221
122222222221
122222222221
122222222221
122222222221
122222222221
122222222221
122222222221
122222222221
122222222221
122222222221
122222222221
122222222221
122222222221
122222222221
122222222221
122222222221
122222222221
122222222221
122222222221
122222222221
122222222221
122222222221
122222222221
122222222221
122222222221
122222222221
122222222221
122222222221
122222222221
122222222221
122222222221
122222222221
122222222221
122222222221
122222222221
122222222221
122222222221
122222222221
122222222221
122222222221
122222222221
122222222221
122222222221
122222222221
122222222221
122222222221
122222222221
122222222221
122222222221
122222222221
122222222221
122222222221
122222222221
122222222221
122222222221
122222222221
122222222221
122222222221
122222222221
122222222221
122222222221
122222222221
122222222221
122222222221
122222222221
122222222221
122222222221
122222222221
122222222221
122222222221
122222222221
122222222221
122222222221
122222222221
122222222221
122222222221
122222222221
122222222221
122222222221
122222222221
122222222221
122222222221
122222222221
122222222221
122222222221
122222222221
122222222221
122222222221
122222222221
122222222221
122222222221
122222222221
122222222221
122222222221
122222222221
122222222221
122222222221
122222222221
122222222221
122222222221
122222222221
122222222221
122222222221
122222222221
122222222221
122222222221
122222222221
122222222221
122222222221
122222222221
122222222221
122222222221
122222222221
122222222221
122222222221
122222222221
122222222221
122222222221
122222222221
122222222221
122222222221
122222222221
122222222221
122222222221
122222222221
122222222221
122222222221
122222222221
122222222221
122222222221
122222222221
122222222221
122222222221
122222222221
122222222221
122222222221
122222222221
122222222221
122222222221
122222222221
122222222221
122222222221
122222222221
122222222221
122222222221
122222222221
122222222221
122222222221
122222222221
122222222221
122222222221
122222222221
122222222221
122222222221
122222222221
122222222221
122222222221
122222222221
122222222221
122222222221
122222222221
122222222221
122222222221
122222222221
122222222221
122222222221
122222222221
122222222221
122222222221
122222222221
122222222221
122222222221
122222222221
122222222221
122222222221
122222222221
122222222221
122222222221
122222222221
122222222221
122222222221
122222222221
122222222221
122222222221
122222222221
122222222221
122222222221
122222222221
122222222221
122222222221
122222222221
122222222221
122222222221
122222222221
122222222221
122222222221
122222222221
122222222221
122222222221
122222222221
122222222221
122222222221
122222222221
122222222221
122222222221
122222222221
122222222221
122222222221
122222222221
122222222221
122222222221
122222222221
122222222221
122222222221
122222222221
122222222221
122222222221
122222222221
122222222221
122222222221
122222222221
122222222221
122222222221
122222222221
122222222221
122222222221
122222222221
122222222221
122222222221
122222222221
122222222221
122222222221
122222222221
122222222221
122222222221
122222222221
122222222221
122222222221
122222222221
122222222221
122222222221
122222222221
122222222221
122222222221
122222222221
122222222221
122222222221
122222222221
122222222221
122222222221
122222222221
122222222221
122222222221
122222222221
122222222221
122222222221
122222222221
122222222221
122222222221
122222222221
122222222221
122222222221
122222222221
122222222221
122222222221
122222222221
122222222221
122222222221
122222222221
122222222221
122222222221
122222222221
122222222221
122222222221
122222222221
122222222221
122222222221
122222222221
122222222221
122222222221
122222222221
122222222221
122222222221
122222222221
122222222221
122222222221
122222222221
122222222221
122222222221
122222222221
122222222221
122222222221
122222222221
122222222221
122222222221
122222222221
122222222221
122222222221
122222222221
122222222221
122222222221
122222222221
122222222221
122222222221
122222222221
122222222221
122222222221
122222222221
122222222221
122222222221
122222222221
122222222221
122222222221
122222222221
122222222221
122222222221
122222222221
122222222221
122222222221
122222222221
122222222221
122222222221
122222222221
122222222221
122222222221
122222222221
122222222221
122222222221
122222222221
122222222221
122222222221
122222222221
122222222221
122222222221
122222222221
122222222221
122222222221
122222222221
122222222221
122222222221
122222222221
122222222221
122222222221
122222222221
122222222221
122222222221
122222222221
122222222221
122222222221
122222222221
122222222221
122222222221
122222222221
122222222221
122222222221
122222222221
122222222221
122222222221
122222222221
122222222221
122222222221
122222222221
122222222221
122222222221
122222222221
122222222221
122222222221
122222222221
122222222221
122222222221
122222222221
122222222221
122222222221
122222222221
122222222221
122222222221
122222222221
122222222221
122222222221
122222222221
122222222221
122222222221
122222222221
122222222221
122222222221
122222222221
122222222221
122222222221
122222222221
122222222221
122222222221
122222222221
122222222221
122222222221
122222222221
122222222221
122222222221
122222222221
122222222221
122222222221
122222222221
122222222221
122222222221
122222222221
122222222221
122222222221
122222222221
122222222221
122222222221
122222222221
122222222221
122222222221
122222222221
122222222221
122222222221
122222222221
122222222221
122222222221
122222222221
122222222221
122222222221
122222222221
122222222221
122222222221
122222222221
122222222221
122222222221
122222222221
122222222221
122222222221
122222222221
122222222221
122222222221
122222222221
122222222221
122222222221
122222222221
122222222221
122222222221
122222222221
122222222221
122222222221
122222222221
122222222221
122222222221
122222222221
122222222221
122222222221
122222222221
122222222221
122222222221
122222222221
122222222221
122222222221
122222222221
122222222221
122222222221
122222222221
122222222221
122222222221
122222222221
122222222221
122222222221
122222222221
122222222221
122222222221
122222222221
122222222221
122222222221
122222222221
122222222221
122222222221
122222222221
122222222221
122222222221
122222222221
122222222221
122222222221
122222222221
122222222221
122222222221
122222222221
122222222221
122222222221
122222222221
122222222221
122222222221
122222222221
122222222221
122222222221
122222222221
122222222221
122222222221
122222222221
122222222221
122222222221
122222222221
122222222221
122222222221
122222222221
122222222221
122222222221
122222222221
122222222221
122222222221
122222222221
122222222221
122222222221
122222222221
122222222221
122222222221
122222222221
122222222221
122222222221
122222222221
122222222221
122222222221
122222222221
122222222221
122222222221
122222222221
122222222221
122222222221
122222222221
122222222221
122222222221
122222222221
122222222221
122222222221
122222222221
122222222221
122222222221
122222222221
122222222221
122222222221
122222222221
122222222221
122222222221
122222222221
122222222221
122222222221
122222222221
122222222221
122222222221
122222222221
122222222221
122222222221
122222222221
122222222221
122222222221
122222222221
122222222221
122222222221
122222222221
122222222221
122222222221
122222222221
122222222221
122222222221
122222222221
122222222221
122222222221
122222222221
122222222221
122222222221
122222222221
122222222221
122222222221
122222222221
122222222221
122222222221
122222222221
122222222221
122222222221
122222222221
122222222221
122222222221
122222222221
122222222221
122222222221
122222222221
122222222221
122222222221
122222222221
122222222221
122222222221
122222222221
122222222221
122222222221
122222222221
122222222221
122222222221
122222222221
122222222221
122222222221
122222222221
122222222221
122222222221
122222222221
122222222221
122222222221
122222222221
122222222221
122222222221
122222222221
122222222221
122222222221
122222222221
122222222221
122222222221
122222222221
122222222221
122222222221
122222222221
122222222221
122222222221
122222222221
122222222221
122222222221
122222222221
122222222221
122222222221
122222222221
122222222221
122222222221
122222222221
122222222221
122222222221
122222222221
122222222221
122222222221
122222222221
122222222221
122222222221
122222222221
122222222221
122222222221
122222222221
122222222221
122222222221
122222222221
122222222221
122222222221
122222222221
122222222221
122222222221
122222222221
122222222221
122222222221
122222222221
122222222221
122222222221
122222222221
122222222221
122222222221
122222222221
122222222221
122222222221
122222222221
122222222221
122222222221
122222222221
122222222221
122222222221
122222222221
122222222221
122222222221
122222222221
122222222221
122222222221
122222222221
122222222221
122222222221
122222222221
122222222221
122222222221
122222222221
122222222221
122222222221
122222222221
122222222221
122222222221
122222222221
122222222221
122222222221
122222222221
122222222221
122222222221
122222222221
122222222221
122222222221
122222222221
122222222221
122222222221
122222222221
122222222221
122222222221
122222222221
122222222221
122222222221
122222222221
122222222221
122222222221
122222222221
122222222221
122222222221
122222222221
122222222221
122222222221
122222222221
122222222221
122222222221
122222222221
122222222221
122222222221
122222222221
122222222221
122222222221
122222222221
122222222221
122222222221
122222222221
122222222221
122222222221
122222222221
122222222221
122222222221
122222222221
122222222221
122222222221
122222222221
122222222221
122222222221
122222222221
122222222221
122222222221
122222222221
122222222221
122222222221
122222222221
122222222221
122222222221
122222222221
122222222221
122222222221
122222222221
122222222221
122222222221
122222222221
122222222221
122222222221
122222222221
122222222221
122222222221
122222222221
122222222221
122222222221
122222222221
122222222221
122222222221
122222222221
122222222221
122222222221
122222222221
122222222221
122222222221
122222222221
122222222221
122222222221
122222222221
122222222221
122222222221
122222222221
122222222221
122222222221
122222222221
122222222221
122222222221
122222222221
122222222221
122222222221
122222222221
122222222221
122222222221
122222222221
122222222221
122222222221
122222222221
122222222221
122222222221
122222222221
122222222221
122222222221
122222222221
122222222221
122222222221
122222222221
122222222221
122222222221
122222222221
122222222221
122222222221
122222222221
122222222221
122222222221
122222222221
122222222221
122222222221
122222222221
122222222221
122222222221
122222222221
122222222221
122222222221
122222222221
122222222221
122222222221
122222222221
122222222221
122222222221
122222222221
122222222221
122222222221
122222222221
122222222221
122222222221
122222222221
122222222221
122222222221
122222222221
122222222221
122222222221
122222222221
122222222221
122222222221
122222222221
122222222221
122222222221
122222222221
122222222221
122222222221
122222222221
122222222221
122222222221
122222222221
122222222221
122222222221
122222222221
122222222221
122222222221
122222222221
122222222221
122222222221
122222222221
122222222221
122222222221
122222222221
122222222221
122222222221
122222222221
122222222221
122222222221
122222222221
122222222221
122222222221
122222222221
122222222221
122222222221
122222222221
122222222221
122222222221
122222222221
122222222221
122222222221
122222222221
122222222221
122222222221
122222222221
122222222221
122222222221
122222222221
122222222221
122222222221
122222222221
122222222221
122222222221
122222222221
122222222221
122222222221
122222222221
122222222221
122222222221
122222222221
122222222221
122222222221
122222222221
122222222221
122222222221
122222222221
122222222221
122222222221
122222222221
122222222221
122222222221
122222222221
122222222221
122222222221
122222222221
122222222221
122222222221
122222222221
122222222221
122222222221
122222222221
122222222221
122222222221
122222222221
122222222221
122222222221
122222222221
122222222221
122222222221
122222222221
122222222221
122222222221
122222222221
122222222221
122222222221
122222222221
122222222221
122222222221
122222222221
122222222221
122222222221
122222222221
122222222221
122222222221
122222222221
122222222221
122222222221
122222222221
122222222221
122222222221
122222222221
122222222221
122222222221
122222222221
122222222221
122222222221
122222222221
122222222221
122222222221
122222222221
122222222221
122222222221
122222222221
122222222221
122222222221
122222222221
122222222221
122222222221
122222222221
122222222221
122222222221
122222222221
122222222221
122222222221
122222222221
122222222221
122222222221
122222222221
122222222221
122222222221
122222222221
122222222221
122222222221
122222222221
122222222221
122222222221
122222222221
122222222221
122222222221
111111111111