R 1920 1080
NO ./texs/test_NO.xpm
SO ./texs/test_SO.xpm
WE ./texs/test_WE.xpm
EA ./texs/test_EA.xpm
S ./texs/test_S.xpm

F 80,80,80
C 80,80,80

        111111111111
        101000000001
        101000000001
        101000000001
11111111100000000001
10000E00020111111111
111110000001
100011100001
100000000001111
100200000000001
111110001111111
    11111